NO ./textures/north.xpm
SO ./textures/south.xpm
WE ./textures/west.xpm
EA ./textures/east.xpm
F 18,8,44
C 101,31,87
11111111111111111111111111111111111
10000000000000000000000000000000001
10111111111101111110111111111111101
10100000001101000010100000000000101
10101111101101011010101111111110101
10101000001001011010100000000010101
10101011111111011010111111101110101
10100010000000011010000000101000101
10111010111111111111111110101110101
10001010100000000000000010101000101
10110010101111111111111010101011101
10110010101000000000001010101010001
10110010101011111111101010101010111
10110000101010000000101010100010001
10111110101010111110101010111010101
10000010101010100010101010001010101
11111010101010101110101011101010101
10001010101010101000101000101010101
10101010101010101011101110101010101
10101000101010100000000000101000101
10101110101010111111111110101110101
10100000101010000000000000101000101
10101111101011111111111110101011101
10101000001000000N0000000001010001
10101011111111111111111111101010101
10101010000000000000000000001010101
10101011111111111111111111101010101
10100000000000000000000000000010101
10111111111111101111111111111110101
10000000000000101000000000000000101
10111111111110101011111111111111101
10100000000010101010000000000000101
10101111111010101011111111111110101
10000000000000000000000000000000001
11111111111111111111111111111111111
