NO ./textures/north.xpm
SO ./textures/south.xpm
WE ./textures/west.xpm
EA ./textures/east.xpm
F 255,0,127
C 0,255,200
1111111111111111111111111111111111111111
1000000000000000000000000000000000000001
1011111111100000000000000001111111111101
1010000000011111111111111100000000001001
1010111110001000000000001000111110101001
1010100011100101111110100011100010101001
1010101001011010000001010100101010101001
1010101010101010111010101010101010101001
1010101001011010000001010100101010101001
1010100011100101111110100011100010101001
1010111110001000000000001000111110101001
1010000000011111111111111100000000001001
1011111111100000000000000001111111111101
1000001000000111111111110000001000000001
1011101011101000000000001011101011101101
1010101010101011111111010101010101010101
1010001010001010000001010001010001010001
1011101011101010111010101110101110101101
1000001000001010101010100000100000100001
1011111111101010101010101111111111101101
1000000000101010N01010100000000000000001
1011111111101010101010101111111111101101
1000001000001010101010100000100000100001
1011101011101010111010101110101110101101
1010001010001010000001010001010001010001
1010101010101011111111010101010101010101
1011101011101000000000001011101011101101
1000001000000111111111110000001000000001
1011111111100000000000000001111111111101
1010000000011111111111111100000000001001
1010111110001000000000001000111110101001
1010100011100101111110100011100010101001
1010101001011010000001010100101010101001
1010101010101010111010101010101010101001
1010101001011010000001010100101010101001
1010100011100101111110100011100010101001
1010111110001000000000001000111110101001
1010000000011111111111111100000000001001
1011111111100000000000000001111111111101
1000000000000000000000000000000000000001
1111111111111111111111111111111111111111
