NO ./textures/north.xpm
SO ./textures/south.xpm
WE ./textures/west.xpm
EA ./textures/east.xpm
F 255,0,255
C 0,255,255
11111111111111111111111111111111111111111111
10000000001000000000000000100000000000000001
10111111101011111111111110101111111111111101
10100000101010000000000010101000000000000101
10101110101010111111111010101011111111110101
10101010101010100000001010101010000000010101
10101010101010101111101010101010111111010101
10101010101010101000101010101010100001010101
10101010101010101010101010101010101101010101
10101010101010101010101010101010101101010101
10101010101010100000001010101010000001010101
10101011101010111111101010101011111101010101
10101000101010000000101010101000000101010101
10101110101011111110101010101111110101010101
10100010101000000010101010100000010101000101
10111010101111111010101010111111010101110101
10001010100000001010101010000001010100010101
10110010111111101010101011111101010101110101
10110010000000101010101000000101010100000101
10110011111110101010101111110101010111111101
10110000000010101010100000010101010000000101
10111111111010101010111111010101011111111101
10000000001010101010000001010101000000000101
11111111101010101011111101010101111111110101
10000000101010101000000101010100000000010101
10111110101010101111110101010111111111010101
10100010101010100000010101010000000001010101
10101010101010111111010101011111111101010101
10101010101010000001010101000000000101010101
10101010101011111101010101111111110101010101
10101010101000000N01010100000000010101010101
10101010101111111111010111111111110101010101
10101010100000000000010000000000000101010101
10101010111111111111111111111111111101010101
10101010000000000000000000000000000001010101
10101011111111111111111111111111111110101101
10100000000000000000000000000000000000001001
10111111111111111111111111111111111111111101
10000000000000000000000000000000000000000001
11111111111111111111111111111111111111111111
